{
"textures": [
1,0,1,0,1,0,1,0,1,0,
0,1,0,1,0,1,0,1,0,1,
1,0,1,0,1,0,1,0,1,0,
0,1,0,1,0,1,0,1,0,1,
1,0,1,0,1,0,1,0,1,0,
0,1,0,1,0,1,0,1,0,1,
1,0,1,0,1,0,1,0,1,0,
0,1,0,1,0,1,0,1,0,1
],

"objects": [
4,2,2,2,2,2,2,2,0,0,
1,1,1,1,1,1,0,1,3,0,
0,0,3,0,3,0,0,1,0,0,
0,3,0,0,0,0,0,0,1,1,
2,3,0,0,2,0,1,1,0,5,
3,3,3,1,2,1,0,0,3,0,
2,3,0,1,2,0,0,3,3,0,
0,0,0,1,2,0,0,0,3,0
],

"name": "A Very Easy Level",

"width": 10,
"height": 8,

"paths": [
"res/bg_blue.png",
"res/bg_green.png"
]
}
