{
"textures": [
0,0,0,0,0,0,0,0,
0,1,0,1,0,1,0,0,
0,0,1,0,1,0,1,0,
0,1,0,1,0,1,0,0,
0,0,1,0,1,0,1,0,
0,1,0,1,0,1,0,0,
0,0,1,0,1,0,1,0,
0,0,0,0,0,0,0,0
],

"objects": [
1,1,1,1,1,1,1,1,
1,5,3,2,3,2,0,1,
1,3,1,1,1,1,3,1,
1,2,1,3,3,1,2,1,
1,1,1,3,3,1,3,1,
1,4,1,1,1,1,2,1,
1,0,2,3,2,3,0,1,
1,1,1,1,1,1,1,1
],

"name": "Deeds' Level",

"width": 8,
"height": 8,

"paths": [
"res/bg_blue.png",
"res/bg_green.png"
]
}
