{
"textures": [
1,0,1,0,1,0,1,0,1,0,1,0,1,0,1,0,
0,1,0,1,0,1,0,1,0,1,0,1,0,1,0,1,
1,0,1,0,1,0,1,0,1,0,1,0,1,0,1,0,
0,1,0,1,0,1,0,1,0,1,0,1,0,1,0,1,
1,0,1,0,1,0,1,0,1,0,1,0,1,0,1,0,
0,1,0,1,0,1,0,1,0,1,0,1,0,1,0,1,
1,0,1,0,1,0,1,0,1,0,1,0,1,0,1,0,
0,1,0,1,0,1,0,1,0,1,0,1,0,1,0,1,
1,0,1,0,1,0,1,0,1,0,1,0,1,0,1,0,
0,1,0,1,0,1,0,1,0,1,0,1,0,1,0,1,
1,0,1,0,1,0,1,0,1,0,1,0,1,0,1,0,
0,1,0,1,0,1,0,1,0,1,0,1,0,1,0,1
],

"objects": [
5,0,3,2,0,1,0,0,0,0,1,0,0,0,0,0,
1,0,3,2,3,1,0,3,0,0,1,0,3,3,0,3,
4,1,0,3,2,1,0,3,3,0,1,0,3,0,1,2,
2,1,1,3,0,1,3,0,0,0,1,0,0,0,1,2,
2,2,1,0,0,1,2,1,0,1,0,0,3,3,1,2,
2,3,1,0,3,2,2,1,0,1,0,0,3,0,1,2,
3,0,0,1,0,3,2,2,3,0,0,1,3,0,1,2,
0,0,0,1,0,0,3,0,1,1,0,0,0,0,1,2,
3,3,0,0,1,1,0,2,2,2,2,0,0,0,1,2,
0,0,1,0,0,0,1,1,1,1,1,0,0,1,0,2,
0,1,1,3,3,3,0,0,0,0,1,3,1,0,0,1,
2,2,2,2,0,3,0,0,0,0,0,0,0,0,1,1
],

"name": "A Harder Level",

"width": 16,
"height": 12,

"paths": [
"res/bg_blue.png",
"res/bg_green.png"
]
}
