{
"textures": [
1,1,1,1,1,1,1,1,1,1,1,
1,0,0,0,0,0,0,0,0,0,1,
1,0,0,1,0,1,0,1,0,0,1,
1,0,1,0,1,0,1,0,1,0,1,
1,0,0,1,0,1,0,1,0,0,1,
1,0,0,0,0,0,0,0,0,0,1,
1,1,1,1,1,1,1,1,1,1,1
],

"objects": [
5,0,0,0,0,0,0,0,0,0,0,
0,0,0,0,0,0,0,0,0,0,0,
0,0,0,0,0,0,0,0,0,0,0,
0,0,0,0,0,0,0,0,0,0,0,
0,0,0,0,0,0,0,0,0,0,0,
0,0,0,0,0,0,0,0,0,0,0,
0,0,0,0,0,0,4,0,0,0,0
],

"width": 11,
"height": 7,

"paths": [
"test_soko/bg_blue.png",
"test_soko/bg_green.png"
]
}
