{
"width": 7,
"height": 12,

"tilesModels": [
2, 2, 2, 2, 2, 2, 2,
2, 119, 86, 86, 86, 102, 2,
2, 78, 374, 342, 358, 70, 2,
2, 76, 332, 514, 326, 70, 2,
2, 78, 382, 350, 366, 70, 2,
2, 126, 94, 94, 94, 110, 2,
2, 114, 82, 82, 82, 98, 2,
2, 74, 246, 214, 230, 66, 2,
2, 74, 206, 386, 198, 66, 2,
2, 74, 254, 222, 238, 66, 2,
2, 122, 90, 90, 90, 106, 2,
2, 2, 2, 2, 2, 2, 2
],

"tilesTextures": [
0, 0, 0, 0, 0, 0, 0,
0, 0, 0, 0, 0, 0, 0,
0, 0, 0, 0, 0, 0, 0,
0, 1, 1, 0, 0, 0, 0,
0, 0, 0, 0, 0, 0, 0,
0, 0, 0, 0, 0, 0, 0,
0, 0, 0, 0, 0, 0, 0,
0, 0, 0, 0, 0, 0, 0,
0, 0, 0, 0, 0, 0, 0,
0, 0, 0, 0, 0, 0, 0,
0, 0, 0, 0, 0, 0, 0
],

"textures": [
  "grass1.png",
  "stairseast.png"
]
}
