{
"width": 7,
"height": 11,

"tilesModels": [
0, 0, 0, 0, 0, 0, 0,
0, 0, 116, 84, 100, 0, 0,
0, 0, 78, 258, 70, 0, 0,
0, 0, 124, 92, 108, 0, 0,
2, 2, 2, 2, 2, 2, 2,
2, 114, 82, 82, 82, 98, 2,
2, 74, 246, 214, 230, 66, 2,
2, 74, 206, 386, 198, 66, 2,
2, 74, 254, 222, 238, 66, 2,
2, 122, 90, 90, 90, 106, 2,
2, 2, 2, 2, 2, 2, 2
],

"textureMap": [
0, 0, 0, 0, 0, 0, 0,
0, 0, 0, 0, 0, 0, 0,
0, 0, 0, 0, 0, 0, 0,
0, 1, 1, 1, 0, 0, 0,
0, 0, 0, 0, 0, 0, 0,
0, 0, 0, 0, 0, 0, 0,
0, 0, 0, 0, 0, 0, 0,
0, 0, 0, 0, 0, 0, 0,
0, 0, 0, 0, 0, 0, 0,
0, 0, 0, 0, 0, 0, 0
],

"textures": [
  "grass1.png",
  "stairseast.png"
]
}
