{
"geometry": [
8, 8, 8,  8,  8,  2,  2, 2, 2, 2, 2,  8,  8,  8,  8, 8,
8, 8, 9,  9,  9,  8,  2, 2, 2, 2, 8,  9,  9,  9,  8, 8,
8, 9, 12, 12, 11, 9,  8, 8, 8, 8, 9,  11, 12, 12, 9, 8,
8, 8, 12, 16, 16, 10, 8, 8, 8, 8, 10, 16, 16, 12, 8, 8,
8, 8, 12, 16, 16, 10, 8, 8, 8, 8, 10, 16, 16, 12, 8, 8,
8, 9, 12, 12, 11, 9,  8, 8, 8, 8, 9,  11, 12, 12, 9, 8,
8, 8, 9,  9,  9,  8,  2, 2, 2, 2, 8,  9,  9,  9,  8, 8,
8, 8, 8,  8,  8,  2,  2, 2, 2, 2, 2,  8,  8,  8,  8, 8
],

"smoothing": [
1, 1, 1, 1, 1, 1, 1, 1, 1, 1, 1, 1, 1, 1, 1,
1, 1, 1, 1, 1, 1, 1, 1, 1, 1, 1, 1, 1, 1, 1,
1, 1, 1, 1, 1, 1, 1, 1, 1, 1, 1, 1, 1, 1, 1,
0, 0, 0, 0, 1, 1, 1, 1, 1, 1, 1, 0, 0, 0, 0,
1, 1, 1, 1, 1, 1, 1, 1, 1, 1, 1, 1, 1, 1, 1,
1, 1, 1, 1, 1, 1, 1, 1, 1, 1, 1, 1, 1, 1, 1,
1, 1, 1, 1, 1, 1, 1, 1, 1, 1, 1, 1, 1, 1, 1
],

"textures": [
0, 0, 0, 0, 0, 0, 0, 0, 0, 0, 0, 0, 0, 0, 0, 
0, 0, 0, 0, 0, 0, 0, 0, 0, 0, 0, 0, 0, 0, 0, 
0, 0, 0, 0, 0, 0, 0, 0, 0, 0, 0, 0, 0, 0, 0, 
1, 1, 1, 1, 0, 0, 0, 0, 0, 0, 0, 1, 1, 1, 1,
0, 0, 0, 0, 0, 0, 0, 0, 0, 0, 0, 0, 0, 0, 0, 
0, 0, 0, 0, 0, 0, 0, 0, 0, 0, 0, 0, 0, 0, 0, 
0, 0, 0, 0, 0, 0, 0, 0, 0, 0, 0, 0, 0, 0, 0
],

"visible": [
1, 1, 1, 1, 1, 1, 1, 1, 1, 1, 1, 1, 1, 1, 1,
1, 1, 1, 1, 1, 1, 1, 1, 1, 1, 1, 1, 1, 1, 1,
1, 1, 1, 1, 1, 1, 1, 1, 1, 1, 1, 1, 1, 1, 1,
1, 0, 0, 0, 1, 1, 1, 1, 1, 1, 1, 0, 0, 0, 1,
1, 1, 1, 1, 1, 1, 1, 1, 1, 1, 1, 1, 1, 1, 1,
1, 1, 1, 1, 1, 1, 1, 1, 1, 1, 1, 1, 1, 1, 1,
1, 1, 1, 1, 1, 1, 1, 1, 1, 1, 1, 1, 1, 1, 1
]
}
